"","subID","degree","outdegree","indegree","degree_scaled","outdegree_scaled","indegree_scaled"
"1","2",2,2,0,-0.581038567823706,0.0117705818588364,-0.955523465203832
"2","2",2,1,1,-0.581038567823706,-0.411970365059275,-0.471032694114565
"3","2",6,4,2,0.614240771699346,0.85925247569506,0.0134580769747018
"4","2",3,0,3,-0.282218732942943,-0.835711311977387,0.497948848063969
"5","2",4,3,1,0.0166011019378201,0.435511528776948,-0.471032694114565
"6","2",6,5,1,0.614240771699346,1.28299342261317,-0.471032694114565
"7","2",3,2,1,-0.282218732942943,0.0117705818588364,-0.471032694114565
"8","2",6,4,2,0.614240771699346,0.85925247569506,0.0134580769747018
"9","2",2,0,2,-0.581038567823706,-0.835711311977387,0.0134580769747018
"10","2",4,0,4,0.0166011019378201,-0.835711311977387,0.982439619153236
"11","2",12,10,2,2.40715978098392,3.40169815720373,0.0134580769747018
"12","2",6,4,2,0.614240771699346,0.85925247569506,0.0134580769747018
"13","2",3,0,3,-0.282218732942943,-0.835711311977387,0.497948848063969
"14","2",5,4,1,0.315420936818583,0.85925247569506,-0.471032694114565
"15","2",6,2,4,0.614240771699346,0.0117705818588364,0.982439619153236
"16","2",7,3,4,0.913060606580109,0.435511528776948,0.982439619153236
"17","2",1,0,1,-0.879858402704469,-0.835711311977387,-0.471032694114565
"18","2",7,2,5,0.913060606580109,0.0117705818588364,1.4669303902425
"19","2",5,4,1,0.315420936818583,0.85925247569506,-0.471032694114565
"20","2",4,1,3,0.0166011019378201,-0.411970365059275,0.497948848063969
"21","2",3,0,3,-0.282218732942943,-0.835711311977387,0.497948848063969
"22","2",8,1,7,1.21188044146087,-0.411970365059275,2.43591193242104
"23","2",5,2,3,0.315420936818583,0.0117705818588364,0.497948848063969
"24","2",6,4,2,0.614240771699346,0.85925247569506,0.0134580769747018
"25","4",7,3,4,0.913060606580109,0.435511528776948,0.982439619153236
"26","4",4,3,1,0.0166011019378201,0.435511528776948,-0.471032694114565
"27","4",9,6,3,1.51070027634163,1.70673436953128,0.497948848063969
"28","4",1,0,1,-0.879858402704469,-0.835711311977387,-0.471032694114565
"29","4",7,4,3,0.913060606580109,0.85925247569506,0.497948848063969
"30","4",4,3,1,0.0166011019378201,0.435511528776948,-0.471032694114565
"31","4",3,1,2,-0.282218732942943,-0.411970365059275,0.0134580769747018
"32","4",3,0,3,-0.282218732942943,-0.835711311977387,0.497948848063969
"33","4",2,1,1,-0.581038567823706,-0.411970365059275,-0.471032694114565
"34","4",2,1,1,-0.581038567823706,-0.411970365059275,-0.471032694114565
"35","4",2,1,1,-0.581038567823706,-0.411970365059275,-0.471032694114565
"36","4",3,2,1,-0.282218732942943,0.0117705818588364,-0.471032694114565
"37","4",3,1,2,-0.282218732942943,-0.411970365059275,0.0134580769747018
"38","4",2,0,2,-0.581038567823706,-0.835711311977387,0.0134580769747018
"39","4",3,2,1,-0.282218732942943,0.0117705818588364,-0.471032694114565
"40","4",1,0,1,-0.879858402704469,-0.835711311977387,-0.471032694114565
"41","4",4,2,2,0.0166011019378201,0.0117705818588364,0.0134580769747018
"42","4",2,1,1,-0.581038567823706,-0.411970365059275,-0.471032694114565
"43","4",2,1,1,-0.581038567823706,-0.411970365059275,-0.471032694114565
"44","4",0,0,0,-1.17867823758523,-0.835711311977387,-0.955523465203832
"45","4",2,1,1,-0.581038567823706,-0.411970365059275,-0.471032694114565
"46","4",4,2,2,0.0166011019378201,0.0117705818588364,0.0134580769747018
"47","4",6,4,2,0.614240771699346,0.85925247569506,0.0134580769747018
"48","4",12,5,7,2.40715978098392,1.28299342261317,2.43591193242104
"49","5",5,5,0,0.315420936818583,1.28299342261317,-0.955523465203832
"50","5",1,0,1,-0.879858402704469,-0.835711311977387,-0.471032694114565
"51","5",1,0,1,-0.879858402704469,-0.835711311977387,-0.471032694114565
"52","5",7,6,1,0.913060606580109,1.70673436953128,-0.471032694114565
"53","5",9,8,1,1.51070027634163,2.55421626336751,-0.471032694114565
"54","5",3,1,2,-0.282218732942943,-0.411970365059275,0.0134580769747018
"55","5",5,3,2,0.315420936818583,0.435511528776948,0.0134580769747018
"56","5",1,0,1,-0.879858402704469,-0.835711311977387,-0.471032694114565
"57","5",11,9,2,2.10833994610316,2.97795721028562,0.0134580769747018
"58","5",5,4,1,0.315420936818583,0.85925247569506,-0.471032694114565
"59","5",7,4,3,0.913060606580109,0.85925247569506,0.497948848063969
"60","5",6,3,3,0.614240771699346,0.435511528776948,0.497948848063969
"61","5",5,2,3,0.315420936818583,0.0117705818588364,0.497948848063969
"62","5",8,1,7,1.21188044146087,-0.411970365059275,2.43591193242104
"63","5",7,3,4,0.913060606580109,0.435511528776948,0.982439619153236
"64","5",3,0,3,-0.282218732942943,-0.835711311977387,0.497948848063969
"65","5",6,2,4,0.614240771699346,0.0117705818588364,0.982439619153236
"66","5",8,0,8,1.21188044146087,-0.835711311977387,2.9204027035103
"67","5",1,0,1,-0.879858402704469,-0.835711311977387,-0.471032694114565
"68","5",3,2,1,-0.282218732942943,0.0117705818588364,-0.471032694114565
"69","5",0,0,0,-1.17867823758523,-0.835711311977387,-0.955523465203832
"70","5",1,0,1,-0.879858402704469,-0.835711311977387,-0.471032694114565
"71","5",1,0,1,-0.879858402704469,-0.835711311977387,-0.471032694114565
"72","5",2,0,2,-0.581038567823706,-0.835711311977387,0.0134580769747018
"73","7",1,0,1,-0.879858402704469,-0.835711311977387,-0.471032694114565
"74","7",2,1,1,-0.581038567823706,-0.411970365059275,-0.471032694114565
"75","7",2,1,1,-0.581038567823706,-0.411970365059275,-0.471032694114565
"76","7",2,1,1,-0.581038567823706,-0.411970365059275,-0.471032694114565
"77","7",5,4,1,0.315420936818583,0.85925247569506,-0.471032694114565
"78","7",4,1,3,0.0166011019378201,-0.411970365059275,0.497948848063969
"79","7",5,3,2,0.315420936818583,0.435511528776948,0.0134580769747018
"80","7",3,1,2,-0.282218732942943,-0.411970365059275,0.0134580769747018
"81","7",4,3,1,0.0166011019378201,0.435511528776948,-0.471032694114565
"82","7",2,1,1,-0.581038567823706,-0.411970365059275,-0.471032694114565
"83","7",5,4,1,0.315420936818583,0.85925247569506,-0.471032694114565
"84","7",4,3,1,0.0166011019378201,0.435511528776948,-0.471032694114565
"85","7",2,0,2,-0.581038567823706,-0.835711311977387,0.0134580769747018
"86","7",2,0,2,-0.581038567823706,-0.835711311977387,0.0134580769747018
"87","7",2,1,1,-0.581038567823706,-0.411970365059275,-0.471032694114565
"88","7",2,1,1,-0.581038567823706,-0.411970365059275,-0.471032694114565
"89","7",2,1,1,-0.581038567823706,-0.411970365059275,-0.471032694114565
"90","7",1,0,1,-0.879858402704469,-0.835711311977387,-0.471032694114565
"91","7",3,2,1,-0.282218732942943,0.0117705818588364,-0.471032694114565
"92","7",3,0,3,-0.282218732942943,-0.835711311977387,0.497948848063969
"93","7",0,0,0,-1.17867823758523,-0.835711311977387,-0.955523465203832
"94","7",2,1,1,-0.581038567823706,-0.411970365059275,-0.471032694114565
"95","7",2,1,1,-0.581038567823706,-0.411970365059275,-0.471032694114565
"96","7",0,0,0,-1.17867823758523,-0.835711311977387,-0.955523465203832
"97","8",0,0,0,-1.17867823758523,-0.835711311977387,-0.955523465203832
"98","8",1,1,0,-0.879858402704469,-0.411970365059275,-0.955523465203832
"99","8",1,1,0,-0.879858402704469,-0.411970365059275,-0.955523465203832
"100","8",2,1,1,-0.581038567823706,-0.411970365059275,-0.471032694114565
"101","8",2,1,1,-0.581038567823706,-0.411970365059275,-0.471032694114565
"102","8",1,0,1,-0.879858402704469,-0.835711311977387,-0.471032694114565
"103","8",2,1,1,-0.581038567823706,-0.411970365059275,-0.471032694114565
"104","8",4,2,2,0.0166011019378201,0.0117705818588364,0.0134580769747018
"105","8",3,3,0,-0.282218732942943,0.435511528776948,-0.955523465203832
"106","8",4,2,2,0.0166011019378201,0.0117705818588364,0.0134580769747018
"107","8",4,3,1,0.0166011019378201,0.435511528776948,-0.471032694114565
"108","8",2,1,1,-0.581038567823706,-0.411970365059275,-0.471032694114565
"109","8",3,2,1,-0.282218732942943,0.0117705818588364,-0.471032694114565
"110","8",1,0,1,-0.879858402704469,-0.835711311977387,-0.471032694114565
"111","8",2,1,1,-0.581038567823706,-0.411970365059275,-0.471032694114565
"112","8",1,0,1,-0.879858402704469,-0.835711311977387,-0.471032694114565
"113","8",3,2,1,-0.282218732942943,0.0117705818588364,-0.471032694114565
"114","8",1,0,1,-0.879858402704469,-0.835711311977387,-0.471032694114565
"115","8",1,0,1,-0.879858402704469,-0.835711311977387,-0.471032694114565
"116","8",2,1,1,-0.581038567823706,-0.411970365059275,-0.471032694114565
"117","8",3,0,3,-0.282218732942943,-0.835711311977387,0.497948848063969
"118","8",2,1,1,-0.581038567823706,-0.411970365059275,-0.471032694114565
"119","8",1,0,1,-0.879858402704469,-0.835711311977387,-0.471032694114565
"120","8",2,1,1,-0.581038567823706,-0.411970365059275,-0.471032694114565
"121","17",2,2,0,-0.581038567823706,0.0117705818588364,-0.955523465203832
"122","17",7,5,2,0.913060606580109,1.28299342261317,0.0134580769747018
"123","17",2,0,2,-0.581038567823706,-0.835711311977387,0.0134580769747018
"124","17",5,4,1,0.315420936818583,0.85925247569506,-0.471032694114565
"125","17",6,0,6,0.614240771699346,-0.835711311977387,1.95142116133177
"126","17",1,0,1,-0.879858402704469,-0.835711311977387,-0.471032694114565
"127","17",3,0,3,-0.282218732942943,-0.835711311977387,0.497948848063969
"128","17",0,0,0,-1.17867823758523,-0.835711311977387,-0.955523465203832
"129","17",8,5,3,1.21188044146087,1.28299342261317,0.497948848063969
"130","17",3,3,0,-0.282218732942943,0.435511528776948,-0.955523465203832
"131","17",1,0,1,-0.879858402704469,-0.835711311977387,-0.471032694114565
"132","17",1,0,1,-0.879858402704469,-0.835711311977387,-0.471032694114565
"133","17",2,2,0,-0.581038567823706,0.0117705818588364,-0.955523465203832
"134","17",2,0,2,-0.581038567823706,-0.835711311977387,0.0134580769747018
"135","17",2,0,2,-0.581038567823706,-0.835711311977387,0.0134580769747018
"136","17",1,0,1,-0.879858402704469,-0.835711311977387,-0.471032694114565
"137","17",3,0,3,-0.282218732942943,-0.835711311977387,0.497948848063969
"138","17",2,1,1,-0.581038567823706,-0.411970365059275,-0.471032694114565
"139","17",1,0,1,-0.879858402704469,-0.835711311977387,-0.471032694114565
"140","17",0,0,0,-1.17867823758523,-0.835711311977387,-0.955523465203832
"141","17",8,6,2,1.21188044146087,1.70673436953128,0.0134580769747018
"142","17",8,5,3,1.21188044146087,1.28299342261317,0.497948848063969
"143","17",3,2,1,-0.282218732942943,0.0117705818588364,-0.471032694114565
"144","17",1,1,0,-0.879858402704469,-0.411970365059275,-0.955523465203832
"145","19",2,2,0,-0.581038567823706,0.0117705818588364,-0.955523465203832
"146","19",1,0,1,-0.879858402704469,-0.835711311977387,-0.471032694114565
"147","19",0,0,0,-1.17867823758523,-0.835711311977387,-0.955523465203832
"148","19",9,8,1,1.51070027634163,2.55421626336751,-0.471032694114565
"149","19",2,0,2,-0.581038567823706,-0.835711311977387,0.0134580769747018
"150","19",2,1,1,-0.581038567823706,-0.411970365059275,-0.471032694114565
"151","19",0,0,0,-1.17867823758523,-0.835711311977387,-0.955523465203832
"152","19",1,1,0,-0.879858402704469,-0.411970365059275,-0.955523465203832
"153","19",1,0,1,-0.879858402704469,-0.835711311977387,-0.471032694114565
"154","19",1,0,1,-0.879858402704469,-0.835711311977387,-0.471032694114565
"155","19",3,2,1,-0.282218732942943,0.0117705818588364,-0.471032694114565
"156","19",5,0,5,0.315420936818583,-0.835711311977387,1.4669303902425
"157","19",7,6,1,0.913060606580109,1.70673436953128,-0.471032694114565
"158","19",4,3,1,0.0166011019378201,0.435511528776948,-0.471032694114565
"159","19",4,4,0,0.0166011019378201,0.85925247569506,-0.955523465203832
"160","19",1,0,1,-0.879858402704469,-0.835711311977387,-0.471032694114565
"161","19",1,0,1,-0.879858402704469,-0.835711311977387,-0.471032694114565
"162","19",2,1,1,-0.581038567823706,-0.411970365059275,-0.471032694114565
"163","19",3,1,2,-0.282218732942943,-0.411970365059275,0.0134580769747018
"164","19",9,2,7,1.51070027634163,0.0117705818588364,2.43591193242104
"165","19",3,1,2,-0.282218732942943,-0.411970365059275,0.0134580769747018
"166","19",4,2,2,0.0166011019378201,0.0117705818588364,0.0134580769747018
"167","19",5,3,2,0.315420936818583,0.435511528776948,0.0134580769747018
"168","19",4,0,4,0.0166011019378201,-0.835711311977387,0.982439619153236
"169","48",2,1,1,-0.581038567823706,-0.411970365059275,-0.471032694114565
"170","48",1,0,1,-0.879858402704469,-0.835711311977387,-0.471032694114565
"171","48",10,9,1,1.8095201112224,2.97795721028562,-0.471032694114565
"172","48",1,0,1,-0.879858402704469,-0.835711311977387,-0.471032694114565
"173","48",2,2,0,-0.581038567823706,0.0117705818588364,-0.955523465203832
"174","48",0,0,0,-1.17867823758523,-0.835711311977387,-0.955523465203832
"175","48",3,2,1,-0.282218732942943,0.0117705818588364,-0.471032694114565
"176","48",2,1,1,-0.581038567823706,-0.411970365059275,-0.471032694114565
"177","48",6,4,2,0.614240771699346,0.85925247569506,0.0134580769747018
"178","48",2,0,2,-0.581038567823706,-0.835711311977387,0.0134580769747018
"179","48",0,0,0,-1.17867823758523,-0.835711311977387,-0.955523465203832
"180","48",6,3,3,0.614240771699346,0.435511528776948,0.497948848063969
"181","48",3,0,3,-0.282218732942943,-0.835711311977387,0.497948848063969
"182","48",8,1,7,1.21188044146087,-0.411970365059275,2.43591193242104
"183","48",2,1,1,-0.581038567823706,-0.411970365059275,-0.471032694114565
"184","48",2,1,1,-0.581038567823706,-0.411970365059275,-0.471032694114565
"185","48",0,0,0,-1.17867823758523,-0.835711311977387,-0.955523465203832
"186","48",3,1,2,-0.282218732942943,-0.411970365059275,0.0134580769747018
"187","48",8,6,2,1.21188044146087,1.70673436953128,0.0134580769747018
"188","48",7,2,5,0.913060606580109,0.0117705818588364,1.4669303902425
"189","48",6,2,4,0.614240771699346,0.0117705818588364,0.982439619153236
"190","48",3,2,1,-0.282218732942943,0.0117705818588364,-0.471032694114565
"191","48",3,1,2,-0.282218732942943,-0.411970365059275,0.0134580769747018
"192","48",6,4,2,0.614240771699346,0.85925247569506,0.0134580769747018
"193","50",2,1,1,-0.581038567823706,-0.411970365059275,-0.471032694114565
"194","50",2,0,2,-0.581038567823706,-0.835711311977387,0.0134580769747018
"195","50",5,4,1,0.315420936818583,0.85925247569506,-0.471032694114565
"196","50",3,1,2,-0.282218732942943,-0.411970365059275,0.0134580769747018
"197","50",1,0,1,-0.879858402704469,-0.835711311977387,-0.471032694114565
"198","50",3,3,0,-0.282218732942943,0.435511528776948,-0.955523465203832
"199","50",3,1,2,-0.282218732942943,-0.411970365059275,0.0134580769747018
"200","50",3,0,3,-0.282218732942943,-0.835711311977387,0.497948848063969
"201","50",6,0,6,0.614240771699346,-0.835711311977387,1.95142116133177
"202","50",6,2,4,0.614240771699346,0.0117705818588364,0.982439619153236
"203","50",1,0,1,-0.879858402704469,-0.835711311977387,-0.471032694114565
"204","50",1,0,1,-0.879858402704469,-0.835711311977387,-0.471032694114565
"205","50",3,2,1,-0.282218732942943,0.0117705818588364,-0.471032694114565
"206","50",4,1,3,0.0166011019378201,-0.411970365059275,0.497948848063969
"207","50",7,5,2,0.913060606580109,1.28299342261317,0.0134580769747018
"208","50",3,0,3,-0.282218732942943,-0.835711311977387,0.497948848063969
"209","50",5,3,2,0.315420936818583,0.435511528776948,0.0134580769747018
"210","50",4,2,2,0.0166011019378201,0.0117705818588364,0.0134580769747018
"211","50",2,1,1,-0.581038567823706,-0.411970365059275,-0.471032694114565
"212","50",6,1,5,0.614240771699346,-0.411970365059275,1.4669303902425
"213","50",3,1,2,-0.282218732942943,-0.411970365059275,0.0134580769747018
"214","50",7,7,0,0.913060606580109,2.13047531644939,-0.955523465203832
"215","50",9,7,2,1.51070027634163,2.13047531644939,0.0134580769747018
"216","50",7,6,1,0.913060606580109,1.70673436953128,-0.471032694114565
"217","22",4,3,1,0.0166011019378201,0.435511528776948,-0.471032694114565
"218","22",4,1,3,0.0166011019378201,-0.411970365059275,0.497948848063969
"219","22",3,2,1,-0.282218732942943,0.0117705818588364,-0.471032694114565
"220","22",7,7,0,0.913060606580109,2.13047531644939,-0.955523465203832
"221","22",2,1,1,-0.581038567823706,-0.411970365059275,-0.471032694114565
"222","22",4,2,2,0.0166011019378201,0.0117705818588364,0.0134580769747018
"223","22",1,0,1,-0.879858402704469,-0.835711311977387,-0.471032694114565
"224","22",4,2,2,0.0166011019378201,0.0117705818588364,0.0134580769747018
"225","22",4,3,1,0.0166011019378201,0.435511528776948,-0.471032694114565
"226","22",2,1,1,-0.581038567823706,-0.411970365059275,-0.471032694114565
"227","22",4,3,1,0.0166011019378201,0.435511528776948,-0.471032694114565
"228","22",5,0,5,0.315420936818583,-0.835711311977387,1.4669303902425
"229","22",4,2,2,0.0166011019378201,0.0117705818588364,0.0134580769747018
"230","22",11,6,5,2.10833994610316,1.70673436953128,1.4669303902425
"231","22",4,3,1,0.0166011019378201,0.435511528776948,-0.471032694114565
"232","22",4,0,4,0.0166011019378201,-0.835711311977387,0.982439619153236
"233","22",3,2,1,-0.282218732942943,0.0117705818588364,-0.471032694114565
"234","22",4,3,1,0.0166011019378201,0.435511528776948,-0.471032694114565
"235","22",3,0,3,-0.282218732942943,-0.835711311977387,0.497948848063969
"236","22",1,0,1,-0.879858402704469,-0.835711311977387,-0.471032694114565
"237","22",2,1,1,-0.581038567823706,-0.411970365059275,-0.471032694114565
"238","22",5,1,4,0.315420936818583,-0.411970365059275,0.982439619153236
"239","22",3,1,2,-0.282218732942943,-0.411970365059275,0.0134580769747018
"240","22",6,3,3,0.614240771699346,0.435511528776948,0.497948848063969
"241","23",9,9,0,1.51070027634163,2.97795721028562,-0.955523465203832
"242","23",0,0,0,-1.17867823758523,-0.835711311977387,-0.955523465203832
"243","23",1,0,1,-0.879858402704469,-0.835711311977387,-0.471032694114565
"244","23",1,0,1,-0.879858402704469,-0.835711311977387,-0.471032694114565
"245","23",2,1,1,-0.581038567823706,-0.411970365059275,-0.471032694114565
"246","23",2,0,2,-0.581038567823706,-0.835711311977387,0.0134580769747018
"247","23",0,0,0,-1.17867823758523,-0.835711311977387,-0.955523465203832
"248","23",0,0,0,-1.17867823758523,-0.835711311977387,-0.955523465203832
"249","23",1,0,1,-0.879858402704469,-0.835711311977387,-0.471032694114565
"250","23",0,0,0,-1.17867823758523,-0.835711311977387,-0.955523465203832
"251","23",1,0,1,-0.879858402704469,-0.835711311977387,-0.471032694114565
"252","23",1,0,1,-0.879858402704469,-0.835711311977387,-0.471032694114565
"253","23",5,0,5,0.315420936818583,-0.835711311977387,1.4669303902425
"254","23",0,0,0,-1.17867823758523,-0.835711311977387,-0.955523465203832
"255","23",7,7,0,0.913060606580109,2.13047531644939,-0.955523465203832
"256","23",3,2,1,-0.282218732942943,0.0117705818588364,-0.471032694114565
"257","23",4,4,0,0.0166011019378201,0.85925247569506,-0.955523465203832
"258","23",1,0,1,-0.879858402704469,-0.835711311977387,-0.471032694114565
"259","23",8,5,3,1.21188044146087,1.28299342261317,0.497948848063969
"260","23",4,1,3,0.0166011019378201,-0.411970365059275,0.497948848063969
"261","23",3,1,2,-0.282218732942943,-0.411970365059275,0.0134580769747018
"262","23",2,0,2,-0.581038567823706,-0.835711311977387,0.0134580769747018
"263","23",2,1,1,-0.581038567823706,-0.411970365059275,-0.471032694114565
"264","23",5,0,5,0.315420936818583,-0.835711311977387,1.4669303902425
"265","24",1,0,1,-0.879858402704469,-0.835711311977387,-0.471032694114565
"266","24",1,0,1,-0.879858402704469,-0.835711311977387,-0.471032694114565
"267","24",1,0,1,-0.879858402704469,-0.835711311977387,-0.471032694114565
"268","24",2,1,1,-0.581038567823706,-0.411970365059275,-0.471032694114565
"269","24",7,5,2,0.913060606580109,1.28299342261317,0.0134580769747018
"270","24",5,3,2,0.315420936818583,0.435511528776948,0.0134580769747018
"271","24",2,1,1,-0.581038567823706,-0.411970365059275,-0.471032694114565
"272","24",1,0,1,-0.879858402704469,-0.835711311977387,-0.471032694114565
"273","24",2,1,1,-0.581038567823706,-0.411970365059275,-0.471032694114565
"274","24",2,0,2,-0.581038567823706,-0.835711311977387,0.0134580769747018
"275","24",0,0,0,-1.17867823758523,-0.835711311977387,-0.955523465203832
"276","24",1,1,0,-0.879858402704469,-0.411970365059275,-0.955523465203832
"277","24",1,0,1,-0.879858402704469,-0.835711311977387,-0.471032694114565
"278","24",1,0,1,-0.879858402704469,-0.835711311977387,-0.471032694114565
"279","24",2,0,2,-0.581038567823706,-0.835711311977387,0.0134580769747018
"280","24",0,0,0,-1.17867823758523,-0.835711311977387,-0.955523465203832
"281","24",2,0,2,-0.581038567823706,-0.835711311977387,0.0134580769747018
"282","24",1,0,1,-0.879858402704469,-0.835711311977387,-0.471032694114565
"283","24",1,0,1,-0.879858402704469,-0.835711311977387,-0.471032694114565
"284","24",1,0,1,-0.879858402704469,-0.835711311977387,-0.471032694114565
"285","24",4,3,1,0.0166011019378201,0.435511528776948,-0.471032694114565
"286","24",3,0,3,-0.282218732942943,-0.835711311977387,0.497948848063969
"287","24",11,11,0,2.10833994610316,3.82543910412184,-0.955523465203832
"288","24",0,0,0,-1.17867823758523,-0.835711311977387,-0.955523465203832
"289","26",7,5,2,0.913060606580109,1.28299342261317,0.0134580769747018
"290","26",1,0,1,-0.879858402704469,-0.835711311977387,-0.471032694114565
"291","26",12,5,7,2.40715978098392,1.28299342261317,2.43591193242104
"292","26",5,2,3,0.315420936818583,0.0117705818588364,0.497948848063969
"293","26",3,0,3,-0.282218732942943,-0.835711311977387,0.497948848063969
"294","26",3,1,2,-0.282218732942943,-0.411970365059275,0.0134580769747018
"295","26",4,2,2,0.0166011019378201,0.0117705818588364,0.0134580769747018
"296","26",2,1,1,-0.581038567823706,-0.411970365059275,-0.471032694114565
"297","26",3,1,2,-0.282218732942943,-0.411970365059275,0.0134580769747018
"298","26",1,0,1,-0.879858402704469,-0.835711311977387,-0.471032694114565
"299","26",7,3,4,0.913060606580109,0.435511528776948,0.982439619153236
"300","26",13,5,8,2.70597961586469,1.28299342261317,2.9204027035103
"301","26",7,6,1,0.913060606580109,1.70673436953128,-0.471032694114565
"302","26",5,2,3,0.315420936818583,0.0117705818588364,0.497948848063969
"303","26",2,1,1,-0.581038567823706,-0.411970365059275,-0.471032694114565
"304","26",1,0,1,-0.879858402704469,-0.835711311977387,-0.471032694114565
"305","26",3,3,0,-0.282218732942943,0.435511528776948,-0.955523465203832
"306","26",1,0,1,-0.879858402704469,-0.835711311977387,-0.471032694114565
"307","26",2,0,2,-0.581038567823706,-0.835711311977387,0.0134580769747018
"308","26",4,3,1,0.0166011019378201,0.435511528776948,-0.471032694114565
"309","26",2,0,2,-0.581038567823706,-0.835711311977387,0.0134580769747018
"310","26",6,4,2,0.614240771699346,0.85925247569506,0.0134580769747018
"311","26",7,6,1,0.913060606580109,1.70673436953128,-0.471032694114565
"312","26",7,4,3,0.913060606580109,0.85925247569506,0.497948848063969
"313","32",4,3,1,0.0166011019378201,0.435511528776948,-0.471032694114565
"314","32",11,10,1,2.10833994610316,3.40169815720373,-0.471032694114565
"315","32",5,4,1,0.315420936818583,0.85925247569506,-0.471032694114565
"316","32",4,2,2,0.0166011019378201,0.0117705818588364,0.0134580769747018
"317","32",5,4,1,0.315420936818583,0.85925247569506,-0.471032694114565
"318","32",2,1,1,-0.581038567823706,-0.411970365059275,-0.471032694114565
"319","32",4,2,2,0.0166011019378201,0.0117705818588364,0.0134580769747018
"320","32",6,3,3,0.614240771699346,0.435511528776948,0.497948848063969
"321","32",6,5,1,0.614240771699346,1.28299342261317,-0.471032694114565
"322","32",9,3,6,1.51070027634163,0.435511528776948,1.95142116133177
"323","32",1,0,1,-0.879858402704469,-0.835711311977387,-0.471032694114565
"324","32",7,6,1,0.913060606580109,1.70673436953128,-0.471032694114565
"325","32",3,2,1,-0.282218732942943,0.0117705818588364,-0.471032694114565
"326","32",4,2,2,0.0166011019378201,0.0117705818588364,0.0134580769747018
"327","32",3,0,3,-0.282218732942943,-0.835711311977387,0.497948848063969
"328","32",1,0,1,-0.879858402704469,-0.835711311977387,-0.471032694114565
"329","32",4,2,2,0.0166011019378201,0.0117705818588364,0.0134580769747018
"330","32",4,1,3,0.0166011019378201,-0.411970365059275,0.497948848063969
"331","32",3,1,2,-0.282218732942943,-0.411970365059275,0.0134580769747018
"332","32",9,5,4,1.51070027634163,1.28299342261317,0.982439619153236
"333","32",15,0,15,3.30361928562621,-0.835711311977387,6.31183810113517
"334","32",2,0,2,-0.581038567823706,-0.835711311977387,0.0134580769747018
"335","32",4,1,3,0.0166011019378201,-0.411970365059275,0.497948848063969
"336","32",6,4,2,0.614240771699346,0.85925247569506,0.0134580769747018
"337","34",0,0,0,-1.17867823758523,-0.835711311977387,-0.955523465203832
"338","34",1,1,0,-0.879858402704469,-0.411970365059275,-0.955523465203832
"339","34",1,0,1,-0.879858402704469,-0.835711311977387,-0.471032694114565
"340","34",6,4,2,0.614240771699346,0.85925247569506,0.0134580769747018
"341","34",2,1,1,-0.581038567823706,-0.411970365059275,-0.471032694114565
"342","34",0,0,0,-1.17867823758523,-0.835711311977387,-0.955523465203832
"343","34",0,0,0,-1.17867823758523,-0.835711311977387,-0.955523465203832
"344","34",5,2,3,0.315420936818583,0.0117705818588364,0.497948848063969
"345","34",6,3,3,0.614240771699346,0.435511528776948,0.497948848063969
"346","34",7,4,3,0.913060606580109,0.85925247569506,0.497948848063969
"347","34",5,4,1,0.315420936818583,0.85925247569506,-0.471032694114565
"348","34",2,1,1,-0.581038567823706,-0.411970365059275,-0.471032694114565
"349","34",9,3,6,1.51070027634163,0.435511528776948,1.95142116133177
"350","34",2,1,1,-0.581038567823706,-0.411970365059275,-0.471032694114565
"351","34",2,1,1,-0.581038567823706,-0.411970365059275,-0.471032694114565
"352","34",2,0,2,-0.581038567823706,-0.835711311977387,0.0134580769747018
"353","34",0,0,0,-1.17867823758523,-0.835711311977387,-0.955523465203832
"354","34",2,1,1,-0.581038567823706,-0.411970365059275,-0.471032694114565
"355","34",2,1,1,-0.581038567823706,-0.411970365059275,-0.471032694114565
"356","34",3,2,1,-0.282218732942943,0.0117705818588364,-0.471032694114565
"357","34",5,2,3,0.315420936818583,0.0117705818588364,0.497948848063969
"358","34",2,1,1,-0.581038567823706,-0.411970365059275,-0.471032694114565
"359","34",2,1,1,-0.581038567823706,-0.411970365059275,-0.471032694114565
"360","34",2,1,1,-0.581038567823706,-0.411970365059275,-0.471032694114565
"361","33",1,0,1,-0.879858402704469,-0.835711311977387,-0.471032694114565
"362","33",0,0,0,-1.17867823758523,-0.835711311977387,-0.955523465203832
"363","33",6,5,1,0.614240771699346,1.28299342261317,-0.471032694114565
"364","33",1,1,0,-0.879858402704469,-0.411970365059275,-0.955523465203832
"365","33",1,0,1,-0.879858402704469,-0.835711311977387,-0.471032694114565
"366","33",5,0,5,0.315420936818583,-0.835711311977387,1.4669303902425
"367","33",2,0,2,-0.581038567823706,-0.835711311977387,0.0134580769747018
"368","33",1,1,0,-0.879858402704469,-0.411970365059275,-0.955523465203832
"369","33",0,0,0,-1.17867823758523,-0.835711311977387,-0.955523465203832
"370","33",5,0,5,0.315420936818583,-0.835711311977387,1.4669303902425
"371","33",5,1,4,0.315420936818583,-0.411970365059275,0.982439619153236
"372","33",0,0,0,-1.17867823758523,-0.835711311977387,-0.955523465203832
"373","33",2,1,1,-0.581038567823706,-0.411970365059275,-0.471032694114565
"374","33",13,13,0,2.70597961586469,4.67292099795806,-0.955523465203832
"375","33",1,0,1,-0.879858402704469,-0.835711311977387,-0.471032694114565
"376","33",1,0,1,-0.879858402704469,-0.835711311977387,-0.471032694114565
"377","33",1,0,1,-0.879858402704469,-0.835711311977387,-0.471032694114565
"378","33",2,0,2,-0.581038567823706,-0.835711311977387,0.0134580769747018
"379","33",7,6,1,0.913060606580109,1.70673436953128,-0.471032694114565
"380","33",6,3,3,0.614240771699346,0.435511528776948,0.497948848063969
"381","33",4,3,1,0.0166011019378201,0.435511528776948,-0.471032694114565
"382","33",4,2,2,0.0166011019378201,0.0117705818588364,0.0134580769747018
"383","33",3,0,3,-0.282218732942943,-0.835711311977387,0.497948848063969
"384","33",3,1,2,-0.282218732942943,-0.411970365059275,0.0134580769747018
"385","31",4,3,1,0.0166011019378201,0.435511528776948,-0.471032694114565
"386","31",4,3,1,0.0166011019378201,0.435511528776948,-0.471032694114565
"387","31",3,2,1,-0.282218732942943,0.0117705818588364,-0.471032694114565
"388","31",4,3,1,0.0166011019378201,0.435511528776948,-0.471032694114565
"389","31",4,1,3,0.0166011019378201,-0.411970365059275,0.497948848063969
"390","31",2,1,1,-0.581038567823706,-0.411970365059275,-0.471032694114565
"391","31",2,0,2,-0.581038567823706,-0.835711311977387,0.0134580769747018
"392","31",1,0,1,-0.879858402704469,-0.835711311977387,-0.471032694114565
"393","31",4,3,1,0.0166011019378201,0.435511528776948,-0.471032694114565
"394","31",4,3,1,0.0166011019378201,0.435511528776948,-0.471032694114565
"395","31",1,0,1,-0.879858402704469,-0.835711311977387,-0.471032694114565
"396","31",3,1,2,-0.282218732942943,-0.411970365059275,0.0134580769747018
"397","31",2,1,1,-0.581038567823706,-0.411970365059275,-0.471032694114565
"398","31",3,2,1,-0.282218732942943,0.0117705818588364,-0.471032694114565
"399","31",2,1,1,-0.581038567823706,-0.411970365059275,-0.471032694114565
"400","31",1,0,1,-0.879858402704469,-0.835711311977387,-0.471032694114565
"401","31",1,0,1,-0.879858402704469,-0.835711311977387,-0.471032694114565
"402","31",1,0,1,-0.879858402704469,-0.835711311977387,-0.471032694114565
"403","31",3,1,2,-0.282218732942943,-0.411970365059275,0.0134580769747018
"404","31",4,3,1,0.0166011019378201,0.435511528776948,-0.471032694114565
"405","31",1,0,1,-0.879858402704469,-0.835711311977387,-0.471032694114565
"406","31",1,0,1,-0.879858402704469,-0.835711311977387,-0.471032694114565
"407","31",2,1,1,-0.581038567823706,-0.411970365059275,-0.471032694114565
"408","31",1,0,1,-0.879858402704469,-0.835711311977387,-0.471032694114565
"409","46",4,3,1,0.0166011019378201,0.435511528776948,-0.471032694114565
"410","46",9,6,3,1.51070027634163,1.70673436953128,0.497948848063969
"411","46",6,5,1,0.614240771699346,1.28299342261317,-0.471032694114565
"412","46",10,4,6,1.8095201112224,0.85925247569506,1.95142116133177
"413","46",10,8,2,1.8095201112224,2.55421626336751,0.0134580769747018
"414","46",16,10,6,3.60243912050698,3.40169815720373,1.95142116133177
"415","46",4,2,2,0.0166011019378201,0.0117705818588364,0.0134580769747018
"416","46",15,6,9,3.30361928562621,1.70673436953128,3.40489347459957
"417","46",5,3,2,0.315420936818583,0.435511528776948,0.0134580769747018
"418","46",7,0,7,0.913060606580109,-0.835711311977387,2.43591193242104
"419","46",8,5,3,1.21188044146087,1.28299342261317,0.497948848063969
"420","46",8,5,3,1.21188044146087,1.28299342261317,0.497948848063969
"421","46",4,2,2,0.0166011019378201,0.0117705818588364,0.0134580769747018
"422","46",4,0,4,0.0166011019378201,-0.835711311977387,0.982439619153236
"423","46",6,4,2,0.614240771699346,0.85925247569506,0.0134580769747018
"424","46",6,5,1,0.614240771699346,1.28299342261317,-0.471032694114565
"425","46",11,6,5,2.10833994610316,1.70673436953128,1.4669303902425
"426","46",3,1,2,-0.282218732942943,-0.411970365059275,0.0134580769747018
"427","46",5,3,2,0.315420936818583,0.435511528776948,0.0134580769747018
"428","46",3,2,1,-0.282218732942943,0.0117705818588364,-0.471032694114565
"429","46",7,3,4,0.913060606580109,0.435511528776948,0.982439619153236
"430","46",3,0,3,-0.282218732942943,-0.835711311977387,0.497948848063969
"431","46",6,0,6,0.614240771699346,-0.835711311977387,1.95142116133177
"432","46",12,3,9,2.40715978098392,0.435511528776948,3.40489347459957
"433","59",2,2,0,-0.581038567823706,0.0117705818588364,-0.955523465203832
"434","59",2,1,1,-0.581038567823706,-0.411970365059275,-0.471032694114565
"435","59",1,1,0,-0.879858402704469,-0.411970365059275,-0.955523465203832
"436","59",1,0,1,-0.879858402704469,-0.835711311977387,-0.471032694114565
"437","59",0,0,0,-1.17867823758523,-0.835711311977387,-0.955523465203832
"438","59",0,0,0,-1.17867823758523,-0.835711311977387,-0.955523465203832
"439","59",0,0,0,-1.17867823758523,-0.835711311977387,-0.955523465203832
"440","59",2,1,1,-0.581038567823706,-0.411970365059275,-0.471032694114565
"441","59",0,0,0,-1.17867823758523,-0.835711311977387,-0.955523465203832
"442","59",1,0,1,-0.879858402704469,-0.835711311977387,-0.471032694114565
"443","59",1,0,1,-0.879858402704469,-0.835711311977387,-0.471032694114565
"444","59",2,2,0,-0.581038567823706,0.0117705818588364,-0.955523465203832
"445","59",2,0,2,-0.581038567823706,-0.835711311977387,0.0134580769747018
"446","59",6,5,1,0.614240771699346,1.28299342261317,-0.471032694114565
"447","59",1,1,0,-0.879858402704469,-0.411970365059275,-0.955523465203832
"448","59",5,4,1,0.315420936818583,0.85925247569506,-0.471032694114565
"449","59",4,2,2,0.0166011019378201,0.0117705818588364,0.0134580769747018
"450","59",2,0,2,-0.581038567823706,-0.835711311977387,0.0134580769747018
"451","59",1,0,1,-0.879858402704469,-0.835711311977387,-0.471032694114565
"452","59",0,0,0,-1.17867823758523,-0.835711311977387,-0.955523465203832
"453","59",2,0,2,-0.581038567823706,-0.835711311977387,0.0134580769747018
"454","59",0,0,0,-1.17867823758523,-0.835711311977387,-0.955523465203832
"455","59",3,0,3,-0.282218732942943,-0.835711311977387,0.497948848063969
"456","59",0,0,0,-1.17867823758523,-0.835711311977387,-0.955523465203832
"457","45",1,1,0,-0.879858402704469,-0.411970365059275,-0.955523465203832
"458","45",10,9,1,1.8095201112224,2.97795721028562,-0.471032694114565
"459","45",4,3,1,0.0166011019378201,0.435511528776948,-0.471032694114565
"460","45",4,2,2,0.0166011019378201,0.0117705818588364,0.0134580769747018
"461","45",6,4,2,0.614240771699346,0.85925247569506,0.0134580769747018
"462","45",8,3,5,1.21188044146087,0.435511528776948,1.4669303902425
"463","45",4,2,2,0.0166011019378201,0.0117705818588364,0.0134580769747018
"464","45",1,0,1,-0.879858402704469,-0.835711311977387,-0.471032694114565
"465","45",5,4,1,0.315420936818583,0.85925247569506,-0.471032694114565
"466","45",1,0,1,-0.879858402704469,-0.835711311977387,-0.471032694114565
"467","45",6,2,4,0.614240771699346,0.0117705818588364,0.982439619153236
"468","45",8,3,5,1.21188044146087,0.435511528776948,1.4669303902425
"469","45",8,6,2,1.21188044146087,1.70673436953128,0.0134580769747018
"470","45",7,2,5,0.913060606580109,0.0117705818588364,1.4669303902425
"471","45",7,4,3,0.913060606580109,0.85925247569506,0.497948848063969
"472","45",8,2,6,1.21188044146087,0.0117705818588364,1.95142116133177
"473","45",6,4,2,0.614240771699346,0.85925247569506,0.0134580769747018
"474","45",6,2,4,0.614240771699346,0.0117705818588364,0.982439619153236
"475","45",5,3,2,0.315420936818583,0.435511528776948,0.0134580769747018
"476","45",6,3,3,0.614240771699346,0.435511528776948,0.497948848063969
"477","45",7,4,3,0.913060606580109,0.85925247569506,0.497948848063969
"478","45",4,1,3,0.0166011019378201,-0.411970365059275,0.497948848063969
"479","45",6,2,4,0.614240771699346,0.0117705818588364,0.982439619153236
"480","45",6,1,5,0.614240771699346,-0.411970365059275,1.4669303902425
"481","61",5,5,0,0.315420936818583,1.28299342261317,-0.955523465203832
"482","61",2,1,1,-0.581038567823706,-0.411970365059275,-0.471032694114565
"483","61",4,3,1,0.0166011019378201,0.435511528776948,-0.471032694114565
"484","61",2,1,1,-0.581038567823706,-0.411970365059275,-0.471032694114565
"485","61",6,5,1,0.614240771699346,1.28299342261317,-0.471032694114565
"486","61",4,3,1,0.0166011019378201,0.435511528776948,-0.471032694114565
"487","61",4,2,2,0.0166011019378201,0.0117705818588364,0.0134580769747018
"488","61",5,2,3,0.315420936818583,0.0117705818588364,0.497948848063969
"489","61",3,3,0,-0.282218732942943,0.435511528776948,-0.955523465203832
"490","61",2,1,1,-0.581038567823706,-0.411970365059275,-0.471032694114565
"491","61",4,2,2,0.0166011019378201,0.0117705818588364,0.0134580769747018
"492","61",5,3,2,0.315420936818583,0.435511528776948,0.0134580769747018
"493","61",3,2,1,-0.282218732942943,0.0117705818588364,-0.471032694114565
"494","61",3,2,1,-0.282218732942943,0.0117705818588364,-0.471032694114565
"495","61",16,2,14,3.60243912050698,0.0117705818588364,5.82734733004591
"496","61",6,5,1,0.614240771699346,1.28299342261317,-0.471032694114565
"497","61",2,0,2,-0.581038567823706,-0.835711311977387,0.0134580769747018
"498","61",3,2,1,-0.282218732942943,0.0117705818588364,-0.471032694114565
"499","61",4,2,2,0.0166011019378201,0.0117705818588364,0.0134580769747018
"500","61",4,0,4,0.0166011019378201,-0.835711311977387,0.982439619153236
"501","61",3,1,2,-0.282218732942943,-0.411970365059275,0.0134580769747018
"502","61",1,0,1,-0.879858402704469,-0.835711311977387,-0.471032694114565
"503","61",4,1,3,0.0166011019378201,-0.411970365059275,0.497948848063969
"504","61",1,0,1,-0.879858402704469,-0.835711311977387,-0.471032694114565
"505","44",2,0,2,-0.581038567823706,-0.835711311977387,0.0134580769747018
"506","44",3,2,1,-0.282218732942943,0.0117705818588364,-0.471032694114565
"507","44",4,3,1,0.0166011019378201,0.435511528776948,-0.471032694114565
"508","44",1,0,1,-0.879858402704469,-0.835711311977387,-0.471032694114565
"509","44",0,0,0,-1.17867823758523,-0.835711311977387,-0.955523465203832
"510","44",0,0,0,-1.17867823758523,-0.835711311977387,-0.955523465203832
"511","44",2,2,0,-0.581038567823706,0.0117705818588364,-0.955523465203832
"512","44",4,3,1,0.0166011019378201,0.435511528776948,-0.471032694114565
"513","44",1,0,1,-0.879858402704469,-0.835711311977387,-0.471032694114565
"514","44",4,1,3,0.0166011019378201,-0.411970365059275,0.497948848063969
"515","44",2,1,1,-0.581038567823706,-0.411970365059275,-0.471032694114565
"516","44",5,3,2,0.315420936818583,0.435511528776948,0.0134580769747018
"517","44",2,2,0,-0.581038567823706,0.0117705818588364,-0.955523465203832
"518","44",2,0,2,-0.581038567823706,-0.835711311977387,0.0134580769747018
"519","44",2,1,1,-0.581038567823706,-0.411970365059275,-0.471032694114565
"520","44",1,0,1,-0.879858402704469,-0.835711311977387,-0.471032694114565
"521","44",1,0,1,-0.879858402704469,-0.835711311977387,-0.471032694114565
"522","44",1,0,1,-0.879858402704469,-0.835711311977387,-0.471032694114565
"523","44",0,0,0,-1.17867823758523,-0.835711311977387,-0.955523465203832
"524","44",4,1,3,0.0166011019378201,-0.411970365059275,0.497948848063969
"525","44",3,3,0,-0.282218732942943,0.435511528776948,-0.955523465203832
"526","44",1,1,0,-0.879858402704469,-0.411970365059275,-0.955523465203832
"527","44",2,1,1,-0.581038567823706,-0.411970365059275,-0.471032694114565
"528","44",1,0,1,-0.879858402704469,-0.835711311977387,-0.471032694114565
"529","43",5,3,2,0.315420936818583,0.435511528776948,0.0134580769747018
"530","43",6,4,2,0.614240771699346,0.85925247569506,0.0134580769747018
"531","43",3,2,1,-0.282218732942943,0.0117705818588364,-0.471032694114565
"532","43",4,3,1,0.0166011019378201,0.435511528776948,-0.471032694114565
"533","43",4,2,2,0.0166011019378201,0.0117705818588364,0.0134580769747018
"534","43",5,3,2,0.315420936818583,0.435511528776948,0.0134580769747018
"535","43",8,6,2,1.21188044146087,1.70673436953128,0.0134580769747018
"536","43",6,4,2,0.614240771699346,0.85925247569506,0.0134580769747018
"537","43",2,1,1,-0.581038567823706,-0.411970365059275,-0.471032694114565
"538","43",3,2,1,-0.282218732942943,0.0117705818588364,-0.471032694114565
"539","43",3,1,2,-0.282218732942943,-0.411970365059275,0.0134580769747018
"540","43",4,0,4,0.0166011019378201,-0.835711311977387,0.982439619153236
"541","43",8,5,3,1.21188044146087,1.28299342261317,0.497948848063969
"542","43",5,3,2,0.315420936818583,0.435511528776948,0.0134580769747018
"543","43",2,0,2,-0.581038567823706,-0.835711311977387,0.0134580769747018
"544","43",2,0,2,-0.581038567823706,-0.835711311977387,0.0134580769747018
"545","43",6,1,5,0.614240771699346,-0.411970365059275,1.4669303902425
"546","43",4,1,3,0.0166011019378201,-0.411970365059275,0.497948848063969
"547","43",4,1,3,0.0166011019378201,-0.411970365059275,0.497948848063969
"548","43",4,2,2,0.0166011019378201,0.0117705818588364,0.0134580769747018
"549","43",3,2,1,-0.282218732942943,0.0117705818588364,-0.471032694114565
"550","43",11,7,4,2.10833994610316,2.13047531644939,0.982439619153236
"551","43",2,1,1,-0.581038567823706,-0.411970365059275,-0.471032694114565
"552","43",6,1,5,0.614240771699346,-0.411970365059275,1.4669303902425
"553","108",0,0,0,-1.17867823758523,-0.835711311977387,-0.955523465203832
"554","108",1,0,1,-0.879858402704469,-0.835711311977387,-0.471032694114565
"555","108",6,5,1,0.614240771699346,1.28299342261317,-0.471032694114565
"556","108",0,0,0,-1.17867823758523,-0.835711311977387,-0.955523465203832
"557","108",2,1,1,-0.581038567823706,-0.411970365059275,-0.471032694114565
"558","108",2,1,1,-0.581038567823706,-0.411970365059275,-0.471032694114565
"559","108",2,1,1,-0.581038567823706,-0.411970365059275,-0.471032694114565
"560","108",0,0,0,-1.17867823758523,-0.835711311977387,-0.955523465203832
"561","108",0,0,0,-1.17867823758523,-0.835711311977387,-0.955523465203832
"562","108",2,1,1,-0.581038567823706,-0.411970365059275,-0.471032694114565
"563","108",2,1,1,-0.581038567823706,-0.411970365059275,-0.471032694114565
"564","108",3,2,1,-0.282218732942943,0.0117705818588364,-0.471032694114565
"565","108",3,1,2,-0.282218732942943,-0.411970365059275,0.0134580769747018
"566","108",1,0,1,-0.879858402704469,-0.835711311977387,-0.471032694114565
"567","108",1,1,0,-0.879858402704469,-0.411970365059275,-0.955523465203832
"568","108",5,1,4,0.315420936818583,-0.411970365059275,0.982439619153236
"569","108",1,0,1,-0.879858402704469,-0.835711311977387,-0.471032694114565
"570","108",2,1,1,-0.581038567823706,-0.411970365059275,-0.471032694114565
"571","108",4,3,1,0.0166011019378201,0.435511528776948,-0.471032694114565
"572","108",2,1,1,-0.581038567823706,-0.411970365059275,-0.471032694114565
"573","108",2,1,1,-0.581038567823706,-0.411970365059275,-0.471032694114565
"574","108",2,1,1,-0.581038567823706,-0.411970365059275,-0.471032694114565
"575","108",5,3,2,0.315420936818583,0.435511528776948,0.0134580769747018
"576","108",2,0,2,-0.581038567823706,-0.835711311977387,0.0134580769747018
"577","42",13,10,3,2.70597961586469,3.40169815720373,0.497948848063969
"578","42",17,11,6,3.90125895538774,3.82543910412184,1.95142116133177
"579","42",8,8,0,1.21188044146087,2.55421626336751,-0.955523465203832
"580","42",14,13,1,3.00479945074545,4.67292099795806,-0.471032694114565
"581","42",3,0,3,-0.282218732942943,-0.835711311977387,0.497948848063969
"582","42",8,0,8,1.21188044146087,-0.835711311977387,2.9204027035103
"583","42",15,8,7,3.30361928562621,2.55421626336751,2.43591193242104
"584","42",20,10,10,4.79771846003003,3.40169815720373,3.88938424568884
"585","42",20,4,16,4.79771846003003,0.85925247569506,6.79632887222444
"586","42",15,3,12,3.30361928562621,0.435511528776948,4.85836578786737
"587","42",8,3,5,1.21188044146087,0.435511528776948,1.4669303902425
"588","42",13,13,0,2.70597961586469,4.67292099795806,-0.955523465203832
"589","42",1,0,1,-0.879858402704469,-0.835711311977387,-0.471032694114565
"590","42",14,14,0,3.00479945074545,5.09666194487618,-0.955523465203832
"591","42",16,14,2,3.60243912050698,5.09666194487618,0.0134580769747018
"592","42",17,17,0,3.90125895538774,6.36788478563051,-0.955523465203832
"593","42",16,3,13,3.60243912050698,0.435511528776948,5.34285655895664
"594","42",14,5,9,3.00479945074545,1.28299342261317,3.40489347459957
"595","42",13,0,13,2.70597961586469,-0.835711311977387,5.34285655895664
"596","42",17,6,11,3.90125895538774,1.70673436953128,4.3738750167781
"597","42",13,5,8,2.70597961586469,1.28299342261317,2.9204027035103
"598","42",6,0,6,0.614240771699346,-0.835711311977387,1.95142116133177
"599","42",18,2,16,4.2000787902685,0.0117705818588364,6.79632887222444
"600","42",17,9,8,3.90125895538774,2.97795721028562,2.9204027035103
"601","41",2,1,1,-0.581038567823706,-0.411970365059275,-0.471032694114565
"602","41",2,1,1,-0.581038567823706,-0.411970365059275,-0.471032694114565
"603","41",4,2,2,0.0166011019378201,0.0117705818588364,0.0134580769747018
"604","41",2,1,1,-0.581038567823706,-0.411970365059275,-0.471032694114565
"605","41",2,1,1,-0.581038567823706,-0.411970365059275,-0.471032694114565
"606","41",2,1,1,-0.581038567823706,-0.411970365059275,-0.471032694114565
"607","41",2,1,1,-0.581038567823706,-0.411970365059275,-0.471032694114565
"608","41",3,1,2,-0.282218732942943,-0.411970365059275,0.0134580769747018
"609","41",2,1,1,-0.581038567823706,-0.411970365059275,-0.471032694114565
"610","41",3,1,2,-0.282218732942943,-0.411970365059275,0.0134580769747018
"611","41",5,3,2,0.315420936818583,0.435511528776948,0.0134580769747018
"612","41",4,3,1,0.0166011019378201,0.435511528776948,-0.471032694114565
"613","41",1,0,1,-0.879858402704469,-0.835711311977387,-0.471032694114565
"614","41",3,2,1,-0.282218732942943,0.0117705818588364,-0.471032694114565
"615","41",1,0,1,-0.879858402704469,-0.835711311977387,-0.471032694114565
"616","41",8,7,1,1.21188044146087,2.13047531644939,-0.471032694114565
"617","41",5,4,1,0.315420936818583,0.85925247569506,-0.471032694114565
"618","41",2,0,2,-0.581038567823706,-0.835711311977387,0.0134580769747018
"619","41",4,2,2,0.0166011019378201,0.0117705818588364,0.0134580769747018
"620","41",3,1,2,-0.282218732942943,-0.411970365059275,0.0134580769747018
"621","41",4,1,3,0.0166011019378201,-0.411970365059275,0.497948848063969
"622","41",4,1,3,0.0166011019378201,-0.411970365059275,0.497948848063969
"623","41",1,0,1,-0.879858402704469,-0.835711311977387,-0.471032694114565
"624","41",1,0,1,-0.879858402704469,-0.835711311977387,-0.471032694114565
"625","39",10,9,1,1.8095201112224,2.97795721028562,-0.471032694114565
"626","39",13,12,1,2.70597961586469,4.24918005103995,-0.471032694114565
"627","39",5,2,3,0.315420936818583,0.0117705818588364,0.497948848063969
"628","39",1,0,1,-0.879858402704469,-0.835711311977387,-0.471032694114565
"629","39",10,8,2,1.8095201112224,2.55421626336751,0.0134580769747018
"630","39",3,0,3,-0.282218732942943,-0.835711311977387,0.497948848063969
"631","39",8,5,3,1.21188044146087,1.28299342261317,0.497948848063969
"632","39",3,1,2,-0.282218732942943,-0.411970365059275,0.0134580769747018
"633","39",3,0,3,-0.282218732942943,-0.835711311977387,0.497948848063969
"634","39",6,2,4,0.614240771699346,0.0117705818588364,0.982439619153236
"635","39",8,3,5,1.21188044146087,0.435511528776948,1.4669303902425
"636","39",6,0,6,0.614240771699346,-0.835711311977387,1.95142116133177
"637","39",4,1,3,0.0166011019378201,-0.411970365059275,0.497948848063969
"638","39",4,3,1,0.0166011019378201,0.435511528776948,-0.471032694114565
"639","39",4,2,2,0.0166011019378201,0.0117705818588364,0.0134580769747018
"640","39",1,0,1,-0.879858402704469,-0.835711311977387,-0.471032694114565
"641","39",6,4,2,0.614240771699346,0.85925247569506,0.0134580769747018
"642","39",5,2,3,0.315420936818583,0.0117705818588364,0.497948848063969
"643","39",8,5,3,1.21188044146087,1.28299342261317,0.497948848063969
"644","39",5,3,2,0.315420936818583,0.435511528776948,0.0134580769747018
"645","39",4,0,4,0.0166011019378201,-0.835711311977387,0.982439619153236
"646","39",4,1,3,0.0166011019378201,-0.411970365059275,0.497948848063969
"647","39",4,1,3,0.0166011019378201,-0.411970365059275,0.497948848063969
"648","39",3,0,3,-0.282218732942943,-0.835711311977387,0.497948848063969
"649","75",6,5,1,0.614240771699346,1.28299342261317,-0.471032694114565
"650","75",5,4,1,0.315420936818583,0.85925247569506,-0.471032694114565
"651","75",1,0,1,-0.879858402704469,-0.835711311977387,-0.471032694114565
"652","75",4,1,3,0.0166011019378201,-0.411970365059275,0.497948848063969
"653","75",3,1,2,-0.282218732942943,-0.411970365059275,0.0134580769747018
"654","75",5,3,2,0.315420936818583,0.435511528776948,0.0134580769747018
"655","75",4,3,1,0.0166011019378201,0.435511528776948,-0.471032694114565
"656","75",3,2,1,-0.282218732942943,0.0117705818588364,-0.471032694114565
"657","75",3,0,3,-0.282218732942943,-0.835711311977387,0.497948848063969
"658","75",3,2,1,-0.282218732942943,0.0117705818588364,-0.471032694114565
"659","75",4,3,1,0.0166011019378201,0.435511528776948,-0.471032694114565
"660","75",5,3,2,0.315420936818583,0.435511528776948,0.0134580769747018
"661","75",3,2,1,-0.282218732942943,0.0117705818588364,-0.471032694114565
"662","75",3,1,2,-0.282218732942943,-0.411970365059275,0.0134580769747018
"663","75",2,1,1,-0.581038567823706,-0.411970365059275,-0.471032694114565
"664","75",1,0,1,-0.879858402704469,-0.835711311977387,-0.471032694114565
"665","75",2,1,1,-0.581038567823706,-0.411970365059275,-0.471032694114565
"666","75",2,0,2,-0.581038567823706,-0.835711311977387,0.0134580769747018
"667","75",4,2,2,0.0166011019378201,0.0117705818588364,0.0134580769747018
"668","75",6,0,6,0.614240771699346,-0.835711311977387,1.95142116133177
"669","75",5,4,1,0.315420936818583,0.85925247569506,-0.471032694114565
"670","75",5,3,2,0.315420936818583,0.435511528776948,0.0134580769747018
"671","75",1,0,1,-0.879858402704469,-0.835711311977387,-0.471032694114565
"672","75",2,0,2,-0.581038567823706,-0.835711311977387,0.0134580769747018
"673","76",0,0,0,-1.17867823758523,-0.835711311977387,-0.955523465203832
"674","76",0,0,0,-1.17867823758523,-0.835711311977387,-0.955523465203832
"675","76",0,0,0,-1.17867823758523,-0.835711311977387,-0.955523465203832
"676","76",0,0,0,-1.17867823758523,-0.835711311977387,-0.955523465203832
"677","76",1,1,0,-0.879858402704469,-0.411970365059275,-0.955523465203832
"678","76",3,3,0,-0.282218732942943,0.435511528776948,-0.955523465203832
"679","76",4,2,2,0.0166011019378201,0.0117705818588364,0.0134580769747018
"680","76",5,4,1,0.315420936818583,0.85925247569506,-0.471032694114565
"681","76",8,5,3,1.21188044146087,1.28299342261317,0.497948848063969
"682","76",3,3,0,-0.282218732942943,0.435511528776948,-0.955523465203832
"683","76",9,8,1,1.51070027634163,2.55421626336751,-0.471032694114565
"684","76",12,9,3,2.40715978098392,2.97795721028562,0.497948848063969
"685","76",9,6,3,1.51070027634163,1.70673436953128,0.497948848063969
"686","76",4,1,3,0.0166011019378201,-0.411970365059275,0.497948848063969
"687","76",16,9,7,3.60243912050698,2.97795721028562,2.43591193242104
"688","76",9,5,4,1.51070027634163,1.28299342261317,0.982439619153236
"689","76",10,4,6,1.8095201112224,0.85925247569506,1.95142116133177
"690","76",5,0,5,0.315420936818583,-0.835711311977387,1.4669303902425
"691","76",6,5,1,0.614240771699346,1.28299342261317,-0.471032694114565
"692","76",7,3,4,0.913060606580109,0.435511528776948,0.982439619153236
"693","76",6,1,5,0.614240771699346,-0.411970365059275,1.4669303902425
"694","76",12,2,10,2.40715978098392,0.0117705818588364,3.88938424568884
"695","76",12,2,10,2.40715978098392,0.0117705818588364,3.88938424568884
"696","76",5,0,5,0.315420936818583,-0.835711311977387,1.4669303902425
"697","78",9,9,0,1.51070027634163,2.97795721028562,-0.955523465203832
"698","78",4,2,2,0.0166011019378201,0.0117705818588364,0.0134580769747018
"699","78",4,3,1,0.0166011019378201,0.435511528776948,-0.471032694114565
"700","78",5,4,1,0.315420936818583,0.85925247569506,-0.471032694114565
"701","78",0,0,0,-1.17867823758523,-0.835711311977387,-0.955523465203832
"702","78",3,1,2,-0.282218732942943,-0.411970365059275,0.0134580769747018
"703","78",2,2,0,-0.581038567823706,0.0117705818588364,-0.955523465203832
"704","78",5,2,3,0.315420936818583,0.0117705818588364,0.497948848063969
"705","78",2,0,2,-0.581038567823706,-0.835711311977387,0.0134580769747018
"706","78",2,0,2,-0.581038567823706,-0.835711311977387,0.0134580769747018
"707","78",3,0,3,-0.282218732942943,-0.835711311977387,0.497948848063969
"708","78",2,0,2,-0.581038567823706,-0.835711311977387,0.0134580769747018
"709","78",5,2,3,0.315420936818583,0.0117705818588364,0.497948848063969
"710","78",2,1,1,-0.581038567823706,-0.411970365059275,-0.471032694114565
"711","78",2,1,1,-0.581038567823706,-0.411970365059275,-0.471032694114565
"712","78",1,0,1,-0.879858402704469,-0.835711311977387,-0.471032694114565
"713","78",1,0,1,-0.879858402704469,-0.835711311977387,-0.471032694114565
"714","78",3,1,2,-0.282218732942943,-0.411970365059275,0.0134580769747018
"715","78",2,1,1,-0.581038567823706,-0.411970365059275,-0.471032694114565
"716","78",2,1,1,-0.581038567823706,-0.411970365059275,-0.471032694114565
"717","78",5,3,2,0.315420936818583,0.435511528776948,0.0134580769747018
"718","78",1,0,1,-0.879858402704469,-0.835711311977387,-0.471032694114565
"719","78",4,3,1,0.0166011019378201,0.435511528776948,-0.471032694114565
"720","78",3,0,3,-0.282218732942943,-0.835711311977387,0.497948848063969
"721","79",14,8,6,3.00479945074545,2.55421626336751,1.95142116133177
"722","79",10,8,2,1.8095201112224,2.55421626336751,0.0134580769747018
"723","79",7,4,3,0.913060606580109,0.85925247569506,0.497948848063969
"724","79",11,5,6,2.10833994610316,1.28299342261317,1.95142116133177
"725","79",4,3,1,0.0166011019378201,0.435511528776948,-0.471032694114565
"726","79",9,4,5,1.51070027634163,0.85925247569506,1.4669303902425
"727","79",5,1,4,0.315420936818583,-0.411970365059275,0.982439619153236
"728","79",6,2,4,0.614240771699346,0.0117705818588364,0.982439619153236
"729","79",8,4,4,1.21188044146087,0.85925247569506,0.982439619153236
"730","79",8,2,6,1.21188044146087,0.0117705818588364,1.95142116133177
"731","79",6,3,3,0.614240771699346,0.435511528776948,0.497948848063969
"732","79",9,4,5,1.51070027634163,0.85925247569506,1.4669303902425
"733","79",9,7,2,1.51070027634163,2.13047531644939,0.0134580769747018
"734","79",9,6,3,1.51070027634163,1.70673436953128,0.497948848063969
"735","79",11,8,3,2.10833994610316,2.55421626336751,0.497948848063969
"736","79",6,2,4,0.614240771699346,0.0117705818588364,0.982439619153236
"737","79",6,3,3,0.614240771699346,0.435511528776948,0.497948848063969
"738","79",6,2,4,0.614240771699346,0.0117705818588364,0.982439619153236
"739","79",6,5,1,0.614240771699346,1.28299342261317,-0.471032694114565
"740","79",9,4,5,1.51070027634163,0.85925247569506,1.4669303902425
"741","79",5,3,2,0.315420936818583,0.435511528776948,0.0134580769747018
"742","79",4,2,2,0.0166011019378201,0.0117705818588364,0.0134580769747018
"743","79",31,9,22,8.08473664371842,2.97795721028562,9.70327349876004
"744","79",9,5,4,1.51070027634163,1.28299342261317,0.982439619153236
"745","83",3,3,0,-0.282218732942943,0.435511528776948,-0.955523465203832
"746","83",2,1,1,-0.581038567823706,-0.411970365059275,-0.471032694114565
"747","83",5,3,2,0.315420936818583,0.435511528776948,0.0134580769747018
"748","83",5,2,3,0.315420936818583,0.0117705818588364,0.497948848063969
"749","83",1,0,1,-0.879858402704469,-0.835711311977387,-0.471032694114565
"750","83",1,0,1,-0.879858402704469,-0.835711311977387,-0.471032694114565
"751","83",1,1,0,-0.879858402704469,-0.411970365059275,-0.955523465203832
"752","83",3,2,1,-0.282218732942943,0.0117705818588364,-0.471032694114565
"753","83",3,2,1,-0.282218732942943,0.0117705818588364,-0.471032694114565
"754","83",3,2,1,-0.282218732942943,0.0117705818588364,-0.471032694114565
"755","83",1,0,1,-0.879858402704469,-0.835711311977387,-0.471032694114565
"756","83",5,4,1,0.315420936818583,0.85925247569506,-0.471032694114565
"757","83",4,3,1,0.0166011019378201,0.435511528776948,-0.471032694114565
"758","83",3,2,1,-0.282218732942943,0.0117705818588364,-0.471032694114565
"759","83",3,0,3,-0.282218732942943,-0.835711311977387,0.497948848063969
"760","83",2,1,1,-0.581038567823706,-0.411970365059275,-0.471032694114565
"761","83",1,0,1,-0.879858402704469,-0.835711311977387,-0.471032694114565
"762","83",2,0,2,-0.581038567823706,-0.835711311977387,0.0134580769747018
"763","83",1,0,1,-0.879858402704469,-0.835711311977387,-0.471032694114565
"764","83",2,1,1,-0.581038567823706,-0.411970365059275,-0.471032694114565
"765","83",1,0,1,-0.879858402704469,-0.835711311977387,-0.471032694114565
"766","83",2,1,1,-0.581038567823706,-0.411970365059275,-0.471032694114565
"767","83",2,1,1,-0.581038567823706,-0.411970365059275,-0.471032694114565
"768","83",4,1,3,0.0166011019378201,-0.411970365059275,0.497948848063969
"769","82",0,0,0,-1.17867823758523,-0.835711311977387,-0.955523465203832
"770","82",0,0,0,-1.17867823758523,-0.835711311977387,-0.955523465203832
"771","82",2,1,1,-0.581038567823706,-0.411970365059275,-0.471032694114565
"772","82",3,2,1,-0.282218732942943,0.0117705818588364,-0.471032694114565
"773","82",6,4,2,0.614240771699346,0.85925247569506,0.0134580769747018
"774","82",1,1,0,-0.879858402704469,-0.411970365059275,-0.955523465203832
"775","82",6,3,3,0.614240771699346,0.435511528776948,0.497948848063969
"776","82",6,4,2,0.614240771699346,0.85925247569506,0.0134580769747018
"777","82",6,5,1,0.614240771699346,1.28299342261317,-0.471032694114565
"778","82",4,2,2,0.0166011019378201,0.0117705818588364,0.0134580769747018
"779","82",6,4,2,0.614240771699346,0.85925247569506,0.0134580769747018
"780","82",6,1,5,0.614240771699346,-0.411970365059275,1.4669303902425
"781","82",7,7,0,0.913060606580109,2.13047531644939,-0.955523465203832
"782","82",4,0,4,0.0166011019378201,-0.835711311977387,0.982439619153236
"783","82",2,1,1,-0.581038567823706,-0.411970365059275,-0.471032694114565
"784","82",6,2,4,0.614240771699346,0.0117705818588364,0.982439619153236
"785","82",4,2,2,0.0166011019378201,0.0117705818588364,0.0134580769747018
"786","82",6,4,2,0.614240771699346,0.85925247569506,0.0134580769747018
"787","82",6,1,5,0.614240771699346,-0.411970365059275,1.4669303902425
"788","82",5,2,3,0.315420936818583,0.0117705818588364,0.497948848063969
"789","82",4,0,4,0.0166011019378201,-0.835711311977387,0.982439619153236
"790","82",6,0,6,0.614240771699346,-0.835711311977387,1.95142116133177
"791","82",1,1,0,-0.879858402704469,-0.411970365059275,-0.955523465203832
"792","82",3,3,0,-0.282218732942943,0.435511528776948,-0.955523465203832
"793","84",2,2,0,-0.581038567823706,0.0117705818588364,-0.955523465203832
"794","84",4,3,1,0.0166011019378201,0.435511528776948,-0.471032694114565
"795","84",4,1,3,0.0166011019378201,-0.411970365059275,0.497948848063969
"796","84",9,6,3,1.51070027634163,1.70673436953128,0.497948848063969
"797","84",4,2,2,0.0166011019378201,0.0117705818588364,0.0134580769747018
"798","84",2,0,2,-0.581038567823706,-0.835711311977387,0.0134580769747018
"799","84",4,2,2,0.0166011019378201,0.0117705818588364,0.0134580769747018
"800","84",0,0,0,-1.17867823758523,-0.835711311977387,-0.955523465203832
"801","84",4,0,4,0.0166011019378201,-0.835711311977387,0.982439619153236
"802","84",3,1,2,-0.282218732942943,-0.411970365059275,0.0134580769747018
"803","84",2,2,0,-0.581038567823706,0.0117705818588364,-0.955523465203832
"804","84",7,5,2,0.913060606580109,1.28299342261317,0.0134580769747018
"805","84",3,2,1,-0.282218732942943,0.0117705818588364,-0.471032694114565
"806","84",0,0,0,-1.17867823758523,-0.835711311977387,-0.955523465203832
"807","84",5,3,2,0.315420936818583,0.435511528776948,0.0134580769747018
"808","84",0,0,0,-1.17867823758523,-0.835711311977387,-0.955523465203832
"809","84",0,0,0,-1.17867823758523,-0.835711311977387,-0.955523465203832
"810","84",2,1,1,-0.581038567823706,-0.411970365059275,-0.471032694114565
"811","84",0,0,0,-1.17867823758523,-0.835711311977387,-0.955523465203832
"812","84",2,1,1,-0.581038567823706,-0.411970365059275,-0.471032694114565
"813","84",3,2,1,-0.282218732942943,0.0117705818588364,-0.471032694114565
"814","84",0,0,0,-1.17867823758523,-0.835711311977387,-0.955523465203832
"815","84",4,0,4,0.0166011019378201,-0.835711311977387,0.982439619153236
"816","84",2,0,2,-0.581038567823706,-0.835711311977387,0.0134580769747018
"817","88",6,3,3,0.614240771699346,0.435511528776948,0.497948848063969
"818","88",6,5,1,0.614240771699346,1.28299342261317,-0.471032694114565
"819","88",2,0,2,-0.581038567823706,-0.835711311977387,0.0134580769747018
"820","88",6,2,4,0.614240771699346,0.0117705818588364,0.982439619153236
"821","88",5,3,2,0.315420936818583,0.435511528776948,0.0134580769747018
"822","88",8,6,2,1.21188044146087,1.70673436953128,0.0134580769747018
"823","88",10,9,1,1.8095201112224,2.97795721028562,-0.471032694114565
"824","88",2,0,2,-0.581038567823706,-0.835711311977387,0.0134580769747018
"825","88",6,5,1,0.614240771699346,1.28299342261317,-0.471032694114565
"826","88",2,0,2,-0.581038567823706,-0.835711311977387,0.0134580769747018
"827","88",2,1,1,-0.581038567823706,-0.411970365059275,-0.471032694114565
"828","88",2,0,2,-0.581038567823706,-0.835711311977387,0.0134580769747018
"829","88",5,2,3,0.315420936818583,0.0117705818588364,0.497948848063969
"830","88",3,2,1,-0.282218732942943,0.0117705818588364,-0.471032694114565
"831","88",2,0,2,-0.581038567823706,-0.835711311977387,0.0134580769747018
"832","88",2,0,2,-0.581038567823706,-0.835711311977387,0.0134580769747018
"833","88",2,0,2,-0.581038567823706,-0.835711311977387,0.0134580769747018
"834","88",6,3,3,0.614240771699346,0.435511528776948,0.497948848063969
"835","88",13,9,4,2.70597961586469,2.97795721028562,0.982439619153236
"836","88",4,2,2,0.0166011019378201,0.0117705818588364,0.0134580769747018
"837","88",4,0,4,0.0166011019378201,-0.835711311977387,0.982439619153236
"838","88",2,0,2,-0.581038567823706,-0.835711311977387,0.0134580769747018
"839","88",3,0,3,-0.282218732942943,-0.835711311977387,0.497948848063969
"840","88",5,2,3,0.315420936818583,0.0117705818588364,0.497948848063969
"841","89",2,2,0,-0.581038567823706,0.0117705818588364,-0.955523465203832
"842","89",8,6,2,1.21188044146087,1.70673436953128,0.0134580769747018
"843","89",6,6,0,0.614240771699346,1.70673436953128,-0.955523465203832
"844","89",9,5,4,1.51070027634163,1.28299342261317,0.982439619153236
"845","89",5,4,1,0.315420936818583,0.85925247569506,-0.471032694114565
"846","89",0,0,0,-1.17867823758523,-0.835711311977387,-0.955523465203832
"847","89",1,1,0,-0.879858402704469,-0.411970365059275,-0.955523465203832
"848","89",6,5,1,0.614240771699346,1.28299342261317,-0.471032694114565
"849","89",13,9,4,2.70597961586469,2.97795721028562,0.982439619153236
"850","89",2,1,1,-0.581038567823706,-0.411970365059275,-0.471032694114565
"851","89",2,0,2,-0.581038567823706,-0.835711311977387,0.0134580769747018
"852","89",6,5,1,0.614240771699346,1.28299342261317,-0.471032694114565
"853","89",8,4,4,1.21188044146087,0.85925247569506,0.982439619153236
"854","89",7,3,4,0.913060606580109,0.435511528776948,0.982439619153236
"855","89",7,2,5,0.913060606580109,0.0117705818588364,1.4669303902425
"856","89",5,0,5,0.315420936818583,-0.835711311977387,1.4669303902425
"857","89",1,0,1,-0.879858402704469,-0.835711311977387,-0.471032694114565
"858","89",5,0,5,0.315420936818583,-0.835711311977387,1.4669303902425
"859","89",6,0,6,0.614240771699346,-0.835711311977387,1.95142116133177
"860","89",0,0,0,-1.17867823758523,-0.835711311977387,-0.955523465203832
"861","89",1,0,1,-0.879858402704469,-0.835711311977387,-0.471032694114565
"862","89",4,0,4,0.0166011019378201,-0.835711311977387,0.982439619153236
"863","89",4,1,3,0.0166011019378201,-0.411970365059275,0.497948848063969
"864","89",0,0,0,-1.17867823758523,-0.835711311977387,-0.955523465203832
"865","90",2,1,1,-0.581038567823706,-0.411970365059275,-0.471032694114565
"866","90",4,2,2,0.0166011019378201,0.0117705818588364,0.0134580769747018
"867","90",3,2,1,-0.282218732942943,0.0117705818588364,-0.471032694114565
"868","90",1,0,1,-0.879858402704469,-0.835711311977387,-0.471032694114565
"869","90",2,1,1,-0.581038567823706,-0.411970365059275,-0.471032694114565
"870","90",2,1,1,-0.581038567823706,-0.411970365059275,-0.471032694114565
"871","90",2,1,1,-0.581038567823706,-0.411970365059275,-0.471032694114565
"872","90",2,1,1,-0.581038567823706,-0.411970365059275,-0.471032694114565
"873","90",2,1,1,-0.581038567823706,-0.411970365059275,-0.471032694114565
"874","90",1,0,1,-0.879858402704469,-0.835711311977387,-0.471032694114565
"875","90",1,0,1,-0.879858402704469,-0.835711311977387,-0.471032694114565
"876","90",2,1,1,-0.581038567823706,-0.411970365059275,-0.471032694114565
"877","90",1,0,1,-0.879858402704469,-0.835711311977387,-0.471032694114565
"878","90",0,0,0,-1.17867823758523,-0.835711311977387,-0.955523465203832
"879","90",1,1,0,-0.879858402704469,-0.411970365059275,-0.955523465203832
"880","90",5,3,2,0.315420936818583,0.435511528776948,0.0134580769747018
"881","90",5,2,3,0.315420936818583,0.0117705818588364,0.497948848063969
"882","90",4,2,2,0.0166011019378201,0.0117705818588364,0.0134580769747018
"883","90",4,2,2,0.0166011019378201,0.0117705818588364,0.0134580769747018
"884","90",4,2,2,0.0166011019378201,0.0117705818588364,0.0134580769747018
"885","90",7,4,3,0.913060606580109,0.85925247569506,0.497948848063969
"886","90",5,3,2,0.315420936818583,0.435511528776948,0.0134580769747018
"887","90",2,1,1,-0.581038567823706,-0.411970365059275,-0.471032694114565
"888","90",2,1,1,-0.581038567823706,-0.411970365059275,-0.471032694114565
"889","80",4,3,1,0.0166011019378201,0.435511528776948,-0.471032694114565
"890","80",3,2,1,-0.282218732942943,0.0117705818588364,-0.471032694114565
"891","80",2,0,2,-0.581038567823706,-0.835711311977387,0.0134580769747018
"892","80",3,2,1,-0.282218732942943,0.0117705818588364,-0.471032694114565
"893","80",3,2,1,-0.282218732942943,0.0117705818588364,-0.471032694114565
"894","80",1,0,1,-0.879858402704469,-0.835711311977387,-0.471032694114565
"895","80",3,1,2,-0.282218732942943,-0.411970365059275,0.0134580769747018
"896","80",3,2,1,-0.282218732942943,0.0117705818588364,-0.471032694114565
"897","80",3,2,1,-0.282218732942943,0.0117705818588364,-0.471032694114565
"898","80",8,4,4,1.21188044146087,0.85925247569506,0.982439619153236
"899","80",6,5,1,0.614240771699346,1.28299342261317,-0.471032694114565
"900","80",5,4,1,0.315420936818583,0.85925247569506,-0.471032694114565
"901","80",1,0,1,-0.879858402704469,-0.835711311977387,-0.471032694114565
"902","80",1,0,1,-0.879858402704469,-0.835711311977387,-0.471032694114565
"903","80",1,0,1,-0.879858402704469,-0.835711311977387,-0.471032694114565
"904","80",4,0,4,0.0166011019378201,-0.835711311977387,0.982439619153236
"905","80",3,2,1,-0.282218732942943,0.0117705818588364,-0.471032694114565
"906","80",1,0,1,-0.879858402704469,-0.835711311977387,-0.471032694114565
"907","80",3,1,2,-0.282218732942943,-0.411970365059275,0.0134580769747018
"908","80",3,2,1,-0.282218732942943,0.0117705818588364,-0.471032694114565
"909","80",1,0,1,-0.879858402704469,-0.835711311977387,-0.471032694114565
"910","80",1,0,1,-0.879858402704469,-0.835711311977387,-0.471032694114565
"911","80",2,1,1,-0.581038567823706,-0.411970365059275,-0.471032694114565
"912","80",1,0,1,-0.879858402704469,-0.835711311977387,-0.471032694114565
"913","92",4,3,1,0.0166011019378201,0.435511528776948,-0.471032694114565
"914","92",6,5,1,0.614240771699346,1.28299342261317,-0.471032694114565
"915","92",2,0,2,-0.581038567823706,-0.835711311977387,0.0134580769747018
"916","92",2,1,1,-0.581038567823706,-0.411970365059275,-0.471032694114565
"917","92",2,1,1,-0.581038567823706,-0.411970365059275,-0.471032694114565
"918","92",5,3,2,0.315420936818583,0.435511528776948,0.0134580769747018
"919","92",4,2,2,0.0166011019378201,0.0117705818588364,0.0134580769747018
"920","92",1,0,1,-0.879858402704469,-0.835711311977387,-0.471032694114565
"921","92",5,4,1,0.315420936818583,0.85925247569506,-0.471032694114565
"922","92",3,2,1,-0.282218732942943,0.0117705818588364,-0.471032694114565
"923","92",2,1,1,-0.581038567823706,-0.411970365059275,-0.471032694114565
"924","92",8,6,2,1.21188044146087,1.70673436953128,0.0134580769747018
"925","92",3,1,2,-0.282218732942943,-0.411970365059275,0.0134580769747018
"926","92",2,1,1,-0.581038567823706,-0.411970365059275,-0.471032694114565
"927","92",3,1,2,-0.282218732942943,-0.411970365059275,0.0134580769747018
"928","92",1,0,1,-0.879858402704469,-0.835711311977387,-0.471032694114565
"929","92",2,0,2,-0.581038567823706,-0.835711311977387,0.0134580769747018
"930","92",1,0,1,-0.879858402704469,-0.835711311977387,-0.471032694114565
"931","92",1,0,1,-0.879858402704469,-0.835711311977387,-0.471032694114565
"932","92",2,0,2,-0.581038567823706,-0.835711311977387,0.0134580769747018
"933","92",2,1,1,-0.581038567823706,-0.411970365059275,-0.471032694114565
"934","92",2,1,1,-0.581038567823706,-0.411970365059275,-0.471032694114565
"935","92",2,0,2,-0.581038567823706,-0.835711311977387,0.0134580769747018
"936","92",1,0,1,-0.879858402704469,-0.835711311977387,-0.471032694114565
